00000000000000000100000000000000
00110000000100000100000000000000
00011000000111111101111000000000
00001110001110000000111000000100
00000011011000000000001100011000
00000000111111000000000011100000
00000001100001111111111001100000
00000000000000001000000000100000
00011011000022001002200000011110
00111110000000001000000000011110
00111100111111001001111111101110
00111000000010001000010000001110
00111000000010011100010000001110
00010000000010000000000000001100
00010000000110000000010000001000
00011000000011000000110000001000
00001000000001111111100000011000
00001100000000000000000000010000
00000111000000011110000000110000
00000001111000000010000011100000
00000000001111111111111110003333
00000000000000000000000000003333
