33000000000000000000000000000000
11111111111111111111111111111000
00010001000010010111111100001000
00010001000010010000001000001000
00010011000010010000001000001000
01110000000000010000001000001000
01000000000000010000001000001000
01010000100010001000001111111110
01010011100010001011100110001000
01010110000010001110000110001000
01011100000010001110000111111000
01010110000010001011000110001000
01010011000010001001100110000000
01010001100010001000110110001110
01010000100010001000010111110000
00000000000000000000000000000000
11111111111111111111111111111100
00000111110000000000000000000000
00011111111111111111111111111111
00000010000000000000001000000000
00000010000100000000001000000000
00000000000100000000000000000000
