00000000000000000000000000000000
01001111111111111111111111111100
01001000000000000000000000000100
01001000000000000000000000000100
01001000111111111111111111100100
01001000100000000000000000100100
01001000100000000000000000100100
01001000100001111111111000100100
01001000100001330000001000100100
01001000100001330000001000100100
01001000100001111100001000100100
01001000100000000000001000100100
01001000100000000000001000100100
01001000111111111111111000100100
01001000000000000000000000100100
01001000000000000000000000100100
01001000000000000000000000100100
01001000000000000000000000100100
01001111111111111111111111100100
01000000000000000000000000000100
01111111111111111111111111111100
00000000000000000000000000000000
