11000000000000111111111111111110
01000000000000001000001000000010
01000100001000101000001001000010
01000100111000101000001001000010
01000100000000100000000001000010
01011111111111100000000001000010
00000000010000100111111111100010
11110111110000100100001000000010
00000000001000100110000000100110
00011111111101111110000000100100
00000000101101111111001000100111
11111110100001111111001111100000
00001100000001001111100111000000
00011111111101001111100110000000
00010111000001001111100111000000
00000100000010000000000111001000
00111101000111111101111111111111
11000001111100000100000000000000
00011111000000000100000000000000
00110000000000000100111111100000
33111111111111111110100000111000
33000000000111111110000000000000
