00000000000000000000000000000331
00001111111111111111111111111331
10001000000000000000000000000331
10011110011111111111111111111111
10010010000000000000000000000001
10010010011111111111111111000001
10010010010000000000000001001001
10010010011110000000000001001001
10010010000010011111111001001001
10010010000010000000221001001001
10010011110010000000221001001001
10000000010011111111111001001001
10000000010000000000001001001001
10011110011111111111111001001001
10010010010000000000000001001001
10010010010000000000000001001001
11110010011100111111111111001001
10000000010000122001000000001001
10000000010000122001000000001001
10011111110011111001111111111001
10000000000010000000000000000001
11111111111111111111111111111111
